8:JJJJJJ
8:JJJJJJP
8:JJJJJP
8:JJJJJP
8:JJJJJJP
8:JJJJJJ
8:JJJJJJ
8:JJJJJJP
8:JJJJJJ
8:JJJJJJP
8:JJJJJJP
8:JJJJJJP
8:JJJJJJ
8:JJJJJJ
8:JJJJJJ
8:JJJJJP
8:JJJJJJ
8:JJJJJJP
8:JJJJJP
8:JJJJJJ
7:JJJJJJ
7:JJJJJJ
7:JJJJJP
7:JJJJJJP
7:JJJJJJ
7:JJJJJP
7:JJJJJJP
7:JJJJJJP
7:JJJJJJP
7:JJJJJJ
7:JJJJJJP
7:JJJJJJP
7:JJJJJP
7:JJJJJJ
7:JJJJJJP
7:JJJJJJP
7:JJJJJJP
7:JJJJJJ
7:JJJJJJP
7:JJJJJJP
6:JJJJJJ
6:JJJJJJP
6:JJJJJP
6:JJJJJJP
6:JJJJJJ
6:JJJJJP
6:JJJJJJP
6:JJJJJP
6:JJJJJP
6:JJJJJJP
6:JJJJJP
6:JJJJJJP
6:JJJJJJ
6:JJJJJP
6:JJJJJJP
6:JJJJJJP
6:JJJJJP
6:JJJJJJP
6:JJJJJJ
6:JJJJJP
5:JJJJJP
5:JJJJJP
5:JJJJJJ
5:JJJJJP
5:JJJJJJ
5:JJJJJJP
5:JJJJJJ
5:JJJJJP
5:JJJJJP
5:JJJJJJ
5:JJJJJP
5:JJJJJJ
5:JJJJJJP
5:JJJJJJ
5:JJJJJJ
5:JJJJJJ
5:JJJJJJP
5:JJJJJJ
5:JJJJJJP
5:JJJJJJP
4:JJJJJJ
4:JJJJJJ
4:JJJJJJ
4:JJJJJP
4:JJJJJJP
4:JJJJJP
4:JJJJJJ
4:JJJJJJ
4:JJJJJJ
4:JJJJJJP
4:JJJJJJP
4:JJJJJP
4:JJJJJJP
4:JJJJJP
4:JJJJJP
4:JJJJJJP
4:JJJJJP
4:JJJJJJ
4:JJJJJJP
4:JJJJJJ
3:JJJJJJ
3:JJJJJJP
3:JJJJJJ
3:JJJJJJP
3:JJJJJJP
3:JJJJJJ
3:JJJJJJ
3:JJJJJJ
3:JJJJJJP
3:JJJJJP
3:JJJJJP
3:JJJJJP
3:JJJJJJ
3:JJJJJP
3:JJJJJJ
3:JJJJJP
3:JJJJJP
3:JJJJJJP
3:JJJJJJ
3:JJJJJP
2:JJJJJJ
2:JJJJJP
2:JJJJJJP
2:JJJJJJP
2:JJJJJP
2:JJJJJJ
2:JJJJJP
2:JJJJJJP
2:JJJJJJP
2:JJJJJJ
2:JJJJJJ
2:JJJJJP
2:JJJJJJP
2:JJJJJP
2:JJJJJJ
2:JJJJJP
2:JJJJJJP
2:JJJJJJP
2:JJJJJJP
2:JJJJJP